60 60
1 33
24 26
34 37
36 27
37 37 37 37 37 37 37 37 37 37 37 37 37 37 37 37 37 37 37 37 37 37 37 37 37 37 37 37 37 37 37 39 58 58 58 58 58 58 58 58 58 58 58 58 58 58 58 58 58 58 58 58 58 58 58 58 58 58 58 58
37 37 37 37 37 37 37 37 37 37 37 37 37 37 37 37 52 41 41 41 41 41 41 41 41 41 41 41 41 41 41 43 0 0 0 0 0 0 0 0 0 0 0 0 0 0 0 0 56 0 0 0 0 0 0 0 3 0 0 58
37 37 37 37 37 37 37 37 37 37 37 37 37 37 37 37 39 0 0 0 0 0 0 0 0 0 0 0 0 0 0 0 0 0 0 0 0 2 0 0 0 0 0 0 0 0 0 0 0 1 0 0 0 0 0 0 0 0 0 58
37 37 37 37 37 37 37 37 37 37 37 37 37 37 37 37 39 0 0 0 0 57 0 0 0 0 0 0 0 0 0 2 0 0 0 0 0 0 0 0 0 0 0 0 0 57 0 0 0 0 0 0 3 0 0 0 0 0 0 58
41 41 41 41 41 53 37 37 37 37 37 37 37 37 37 37 39 0 0 0 1 0 0 0 0 0 0 0 0 0 0 0 0 0 0 0 0 0 0 56 0 0 0 0 0 0 0 0 0 0 0 0 0 0 0 0 0 0 0 58
58 58 58 58 58 38 37 37 37 37 37 37 37 37 37 37 39 0 0 0 0 0 0 0 0 0 0 0 0 0 0 0 0 0 0 2 0 0 0 0 0 0 0 0 0 0 0 0 0 0 57 0 0 0 56 0 0 0 0 58
7 7 7 12 58 38 37 37 37 37 37 37 37 37 37 37 39 0 0 0 0 0 0 0 0 0 0 0 0 57 0 0 0 0 0 0 0 0 0 0 0 0 0 0 0 3 0 0 0 0 0 0 0 0 0 0 0 0 0 58
4 4 4 6 58 38 37 37 37 37 37 37 37 37 37 37 39 0 0 0 0 0 0 0 0 3 0 0 0 0 0 0 0 0 0 0 0 0 0 0 0 0 0 0 0 0 0 0 2 0 0 0 0 0 0 0 0 0 0 58
4 4 4 6 58 38 37 37 37 37 37 37 37 37 37 37 39 0 0 0 0 0 0 0 0 0 0 0 0 0 0 0 0 0 0 0 0 0 0 0 0 0 56 0 0 0 0 0 0 0 0 0 57 0 0 0 0 0 0 58
4 4 4 6 58 38 37 37 37 37 37 37 37 37 37 37 39 0 0 0 57 0 0 0 0 0 0 0 0 0 0 0 0 0 0 0 0 0 0 0 0 0 0 0 0 0 0 0 0 0 0 0 3 0 0 0 1 0 0 58
4 4 4 6 58 38 37 52 41 41 41 41 41 41 41 41 43 0 0 0 0 0 0 0 0 0 2 0 0 0 0 0 0 0 1 0 0 0 0 0 0 0 0 0 0 0 0 0 0 0 0 0 0 0 0 0 0 0 0 58
4 4 4 6 58 38 37 46 0 2 0 0 0 0 0 0 0 0 0 0 0 0 0 0 0 0 0 0 0 0 0 0 0 0 0 0 0 0 0 0 0 0 0 0 0 0 0 3 0 0 0 0 0 0 0 0 0 0 0 58
4 4 4 6 58 38 37 46 28 0 0 0 0 0 0 0 0 0 54 54 54 54 54 54 54 54 54 54 54 54 54 54 54 54 54 54 0 0 11 7 7 7 7 7 7 7 7 7 12 0 0 0 0 0 0 0 0 0 0 58
4 4 4 6 58 38 37 46 28 11 7 7 7 7 7 7 12 0 54 54 54 54 54 54 54 54 54 54 54 54 54 54 54 54 54 54 0 0 5 4 4 4 4 4 4 4 4 4 6 0 0 0 0 0 2 0 0 0 0 58
4 4 4 6 58 38 37 46 28 5 4 4 4 4 4 4 6 0 54 54 54 54 54 54 54 54 54 54 54 54 54 54 54 54 54 54 2 0 5 4 4 4 4 4 4 4 4 4 6 0 0 0 0 0 0 0 0 0 0 58
4 4 4 6 58 38 37 46 28 5 4 4 4 4 4 4 6 0 54 54 54 54 54 54 54 54 54 54 54 54 54 54 54 54 54 54 0 0 5 4 4 13 8 8 8 14 4 4 6 0 0 0 0 56 0 0 0 0 0 58
4 4 4 6 58 38 37 46 28 5 4 4 4 4 4 4 6 0 54 54 54 54 54 54 0 54 54 54 54 54 54 54 54 54 54 54 0 0 5 4 4 6 1 0 56 5 4 4 6 0 0 0 0 0 0 0 0 0 0 58
4 4 4 6 58 38 37 46 28 5 4 4 4 4 4 4 6 0 54 54 54 54 54 54 54 54 54 54 54 54 54 54 54 54 54 54 0 0 9 8 8 10 0 0 0 5 4 4 6 0 0 0 0 1 0 0 0 0 0 58
4 4 4 6 58 38 37 46 28 5 4 4 4 4 4 4 6 0 54 54 54 54 54 54 54 54 54 54 54 54 54 54 54 54 54 54 0 0 0 0 0 0 0 0 0 5 4 4 6 0 0 0 0 0 0 0 57 0 0 58
4 4 4 6 58 38 37 46 28 5 4 4 4 4 4 4 6 0 54 54 54 54 54 54 54 54 54 54 54 54 54 54 54 54 54 54 0 0 0 0 0 0 0 0 0 5 4 4 6 0 0 0 0 0 0 0 0 0 0 58
4 4 4 6 58 38 37 46 28 5 4 4 4 4 4 4 6 0 0 0 0 0 0 0 0 0 0 0 0 0 0 0 0 0 0 0 0 0 0 0 0 0 0 0 3 5 4 4 6 0 0 0 0 0 0 0 0 3 0 58
4 4 4 6 58 38 37 46 28 5 4 4 4 4 4 4 15 7 7 7 7 7 7 7 7 7 7 7 7 7 7 7 7 7 7 7 7 7 7 7 7 7 7 12 58 5 4 4 6 0 56 0 0 0 0 0 0 0 0 58
4 4 4 6 58 38 37 46 28 5 4 4 4 4 4 4 4 4 4 4 4 4 4 4 4 4 4 4 4 4 4 4 4 4 4 4 4 4 4 4 4 4 4 6 58 5 4 4 6 0 0 0 0 0 0 0 0 0 0 58
4 4 4 6 58 38 37 46 28 5 4 4 4 4 4 4 4 4 4 4 4 4 4 4 4 4 4 4 4 4 4 4 4 4 4 4 4 4 4 4 4 4 4 6 58 5 4 4 6 0 0 0 0 0 0 0 0 0 0 58
8 8 8 10 58 38 37 46 28 5 4 4 13 8 8 8 8 8 8 8 8 8 8 8 8 8 8 8 8 8 8 8 8 8 8 8 8 8 8 8 8 8 8 10 58 5 4 4 6 0 0 0 0 0 0 0 0 0 0 58
0 0 0 0 58 38 37 46 28 5 4 4 6 58 0 0 54 54 54 54 54 0 0 0 0 0 0 0 0 0 0 0 2 0 0 0 0 0 0 0 0 0 3 0 0 5 4 4 6 0 0 0 1 0 0 0 0 0 0 58
58 58 58 58 58 38 37 46 28 5 4 4 6 58 0 0 54 54 54 54 54 0 56 0 0 0 0 0 0 0 0 0 0 0 0 57 0 0 0 0 0 0 0 0 0 5 4 4 6 0 0 0 0 0 0 56 0 0 0 58
40 40 40 40 40 51 37 46 28 5 4 4 6 58 3 0 54 54 54 54 54 0 0 0 0 2 0 0 0 0 0 0 0 0 0 0 0 1 0 0 0 0 0 0 0 5 4 4 6 0 0 0 0 0 0 0 0 0 0 58
37 37 37 37 37 37 37 46 28 5 4 4 6 58 0 0 0 0 0 0 0 0 0 0 0 0 0 0 0 0 0 0 0 0 0 0 0 0 0 0 0 0 0 0 0 5 4 4 6 0 0 0 0 0 0 0 0 0 0 58
41 41 41 41 41 41 41 43 28 5 4 4 15 7 7 7 7 7 7 7 7 7 7 12 0 0 0 0 0 0 0 0 3 0 0 0 0 0 0 0 0 0 0 0 0 5 4 4 6 0 0 0 2 0 0 0 56 0 0 58
29 29 29 29 29 29 29 29 32 5 4 4 4 4 4 4 4 4 4 4 4 4 4 6 0 0 0 0 0 1 0 0 0 0 0 0 0 0 0 0 0 0 0 0 0 5 4 4 6 0 0 0 0 0 3 0 0 0 0 58
7 7 7 7 7 7 7 7 7 16 4 4 4 4 4 4 4 4 4 4 4 4 4 6 0 0 0 0 0 0 56 0 0 0 0 0 0 0 0 0 0 0 0 0 0 5 4 4 6 0 0 0 0 0 0 0 0 0 0 58
4 4 4 4 4 4 4 4 4 4 4 4 13 8 8 8 8 8 8 8 14 4 4 6 0 0 0 0 0 0 0 0 0 0 0 0 0 0 0 0 0 0 0 0 0 5 4 4 6 0 0 0 0 0 0 0 0 1 0 58
4 4 4 4 4 4 4 4 4 4 4 4 6 0 56 0 56 0 56 0 5 4 4 15 7 7 7 7 7 7 7 7 7 7 7 7 7 7 7 7 7 7 7 7 7 16 4 4 6 0 0 0 0 0 2 0 0 0 0 58
8 8 8 8 8 8 8 8 8 14 4 4 6 56 0 56 0 56 0 56 5 4 4 4 4 4 4 4 4 4 4 4 4 4 4 4 4 4 4 4 4 4 4 4 4 4 4 4 6 0 0 0 57 0 0 0 0 0 0 58
30 30 30 30 30 30 30 34 0 5 4 4 6 0 0 0 0 0 0 0 5 4 4 4 4 4 4 4 4 4 4 4 4 4 4 4 4 4 4 4 4 4 4 4 4 4 4 4 6 0 0 0 0 0 0 0 0 0 0 58
58 0 0 0 0 0 0 28 0 5 4 4 6 0 0 0 0 0 0 0 5 4 4 13 8 8 8 8 8 8 8 8 8 8 8 8 8 8 8 8 8 8 8 8 8 8 8 8 10 0 0 0 0 0 0 57 0 0 0 58
58 0 0 0 0 0 0 28 0 5 4 4 6 0 0 54 54 54 54 0 5 4 4 6 58 0 0 0 0 0 0 0 0 0 0 0 0 0 0 0 0 0 3 0 0 0 0 0 0 0 0 0 0 0 0 0 0 0 0 58
58 0 0 0 2 0 0 28 0 5 4 4 6 0 0 54 54 54 54 0 5 4 4 6 58 0 56 0 0 0 0 0 0 0 0 0 0 0 0 0 0 0 0 0 0 0 0 0 0 0 2 0 0 0 0 0 56 0 0 58
58 0 56 0 0 0 0 28 0 5 4 4 6 0 0 54 54 54 54 0 5 4 4 6 58 1 0 0 0 0 0 0 0 0 0 0 0 0 0 0 0 56 0 3 0 0 57 0 0 0 0 0 0 0 0 0 0 0 0 58
58 0 0 0 0 0 0 28 0 5 4 4 6 0 0 54 54 54 54 0 5 4 4 6 58 0 0 0 57 0 0 0 0 0 0 0 0 0 0 0 0 0 0 0 0 0 0 0 0 0 0 1 0 0 0 0 0 0 0 58
58 0 0 0 0 0 0 28 0 5 4 4 6 0 0 0 0 0 0 0 5 4 4 6 58 0 0 0 0 0 0 0 0 0 0 0 0 0 0 0 0 0 0 0 0 0 0 0 0 0 0 0 0 0 0 0 0 0 0 58
58 0 0 0 56 0 0 28 0 5 4 4 15 7 7 7 7 7 7 7 16 4 4 15 7 7 7 7 7 7 7 7 7 7 7 7 7 7 7 7 7 7 7 7 7 7 7 7 12 0 0 0 0 0 0 0 0 0 0 58
58 0 0 0 0 0 0 28 0 5 4 4 4 4 4 4 4 4 4 4 4 4 4 4 4 4 4 4 4 4 4 4 4 4 4 4 4 4 4 4 4 4 4 4 4 4 4 4 6 0 0 0 0 0 0 0 0 0 0 58
58 0 0 0 0 0 0 28 0 5 4 4 4 4 4 4 4 4 4 4 4 4 4 4 4 4 4 4 4 4 4 4 4 4 4 4 4 4 4 4 4 4 4 4 4 4 4 4 6 0 2 0 0 0 0 0 0 0 0 58
58 0 0 0 0 0 0 28 0 9 8 8 8 8 8 8 8 8 8 8 8 8 8 8 8 8 8 8 8 8 8 8 8 8 8 8 8 8 8 8 8 8 8 8 8 8 8 8 10 0 0 0 3 0 0 0 0 0 0 58
58 0 0 0 0 0 0 28 2 0 0 0 0 0 0 0 0 0 0 0 0 2 0 0 0 0 0 0 0 0 0 0 0 0 0 0 0 0 0 0 0 0 0 0 0 0 0 0 0 0 0 0 0 0 0 0 0 0 0 58
49 49 49 49 45 0 0 28 0 0 0 0 0 0 0 0 0 0 0 0 0 0 0 0 0 0 0 0 0 3 0 0 0 0 0 0 0 0 2 57 0 0 56 0 0 0 0 0 0 0 0 0 0 0 0 56 0 0 0 58
37 37 37 37 46 0 0 28 0 0 0 0 0 0 56 0 0 0 0 0 0 0 0 0 0 0 0 0 0 0 0 0 0 0 0 0 0 0 0 0 0 0 0 0 0 0 0 0 0 0 0 0 0 0 0 0 0 0 0 58
37 37 37 37 46 0 0 28 0 0 0 0 1 0 0 0 0 0 0 0 0 0 0 56 0 0 0 0 0 0 0 0 0 2 0 0 0 0 0 0 0 0 0 0 0 0 0 0 0 0 0 0 0 1 0 0 0 0 0 58
37 37 37 37 46 0 0 0 0 0 0 0 0 0 0 0 0 0 0 0 57 0 0 0 0 0 0 0 0 0 57 0 0 0 0 0 0 56 0 0 0 0 0 0 0 0 0 0 0 0 0 57 0 0 0 0 0 0 0 58
37 37 37 37 46 0 0 0 0 0 0 0 0 0 0 0 0 0 0 0 0 0 0 0 0 0 0 0 0 0 0 0 0 0 0 0 0 0 0 0 0 0 0 0 0 0 56 0 0 0 0 0 0 0 0 0 0 0 0 58
37 37 37 37 46 0 0 0 0 0 0 0 0 0 0 0 0 0 0 0 0 0 0 0 0 0 0 0 56 0 0 0 0 0 0 0 0 0 0 0 0 0 0 0 1 0 0 0 0 2 0 0 0 0 0 0 0 0 0 58
37 37 37 37 50 49 49 49 49 49 49 49 49 49 49 49 49 49 49 49 49 49 49 49 49 49 49 49 49 49 49 49 49 49 49 49 49 49 49 49 49 49 49 49 49 49 49 49 49 49 49 49 49 49 49 49 49 49 49 49
37 37 37 37 37 37 37 37 37 37 37 37 37 37 37 37 37 37 37 37 37 37 37 37 37 37 37 37 37 37 37 37 37 37 37 37 37 37 37 37 37 37 37 37 37 37 37 37 37 37 37 37 37 37 37 37 37 37 37 37
37 37 37 37 37 37 37 37 37 37 37 37 37 37 37 37 37 37 37 37 37 37 37 37 37 37 37 37 37 37 37 37 37 37 37 37 37 37 37 37 37 37 37 37 37 37 37 37 37 37 37 37 37 37 37 37 37 37 37 37
37 37 37 37 37 37 37 37 37 37 37 37 37 37 37 37 37 37 37 37 37 37 37 37 37 37 37 37 37 37 37 37 37 37 37 37 37 37 37 37 37 37 37 37 37 37 37 37 37 37 37 37 37 37 37 37 37 37 37 37
37 37 37 37 37 37 37 37 37 37 37 37 37 37 37 37 37 37 37 37 37 37 37 37 37 37 37 37 37 37 37 37 37 37 37 37 37 37 37 37 37 37 37 37 37 37 37 37 37 37 37 37 37 37 37 37 37 37 37 37
37 37 37 37 37 37 37 37 37 37 37 37 37 37 37 37 37 37 37 37 37 37 37 37 37 37 37 37 37 37 37 37 37 37 37 37 37 37 37 37 37 37 37 37 37 37 37 37 37 37 37 37 37 37 37 37 37 37 37 37
37 37 37 37 37 37 37 37 37 37 37 37 37 37 37 37 37 37 37 37 37 37 37 37 37 37 37 37 37 37 37 37 37 37 37 37 37 37 37 37 37 37 37 37 37 37 37 37 37 37 37 37 37 37 37 37 37 37 37 37